5555555555555555555555555555
5000000550000005500000000005
5000000550000005500000000005
5001100550000001100110011005
5001100550000001100110011005
5001100000000111100115511005
5001100000000111100115511005
5000000110000000000550000005
5000000110000000000550000005
5440000110000550000114411555
5440000110000550000114411555
5444400000011000055004400005
5444400000011000055004400005
5001111114444445500004411005
5001111114444445500004411005
5000000554411001100110011005
5000000554411001100110011005
5551100550011001100000011005
5551100550011001100000011005
5001100110011111100115511005
5001100110011111100115511005
5001100110011111100000000005
5001100110011111100000000005
5001100000000000000110011005
5001100000001111000110011005
5001100110001001000111111005
5001100110001001000111111005
5555555555555555555555555555