5555555555555555555555555555
5000000550000001100000000005
5000000550000001100000000005
5001100550000001100110011005
5001100550000001100110011005
5001100000000111100111111005
5001100000000111100111111005
5000000110000000000550000005
5000000110000000000550000005
5440000110000552222114411555
5440000110000552222114411555
5444400000011000055004400005
5444400000011000055004400005
5001111114444445500004411005
5001111114444445500004411005
5000000554411001100110011005
5000000554411001100110011005
5551122550011001100222211225
5551122550011001100222211225
5221122110011111100115511225
5221122110011111100115511225
5221100110011111100000000225
5221100110011111100000000225
5221100000000000000110011225
5221100000001111000110011225
5221100110001001000111111005
5221100110001001000111111005
5555555555555555555555555555